// Size Mapa, Initial position, dirty probability, random seed, map
10 4 4 0 1
0 0 0 0 0 0 0 0 0 0 
0 1 1 1 1 1 1 1 1 0 
0 1 0 0 0 0 0 0 1 0 
0 1 0 1 1 5 5 0 1 0 
0 5 0 1 1 1 1 5 1 0 
0 5 0 1 1 1 1 0 1 0 
0 1 0 1 1 1 1 0 1 0 
0 1 0 1 0 0 0 0 5 0 
0 1 5 1 1 1 6 1 1 0 
0 0 0 0 0 0 0 0 0 0 
