// Size Mapa, Initial position, dirty probability, random seed, map
10 4 3 0 1
0 0 0 0 0 0 0 0 0 0 
0 1 1 4 1 1 1 1 1 0 
0 0 0 0 0 0 0 1 1 0 
0 1 1 1 1 1 1 1 1 0 
0 1 1 1 1 1 1 1 1 0 
0 1 1 1 1 1 1 1 1 0 
0 1 1 1 1 1 1 1 1 0 
0 1 1 1 1 1 1 1 1 0 
0 1 1 1 1 1 1 4 1 0 
0 0 0 0 0 0 0 0 0 0 
