// Size Mapa, Initial position Green Player, Inital position Blue Player,  map
15 5 5 3 5 6 1
0 0 0 0 0 0 0 0 0 0 0 0 0 0 0 
0 1 1 1 1 1 1 1 3 1 2 1 2 2 0 
0 1 1 1 1 1 3 2 3 1 1 1 1 1 0 
0 2 1 1 1 1 1 1 2 1 1 1 2 2 0 
0 1 2 1 1 1 2 1 1 1 1 1 1 1 0 
0 1 1 1 1 1 1 1 2 1 1 2 1 1 0 
0 1 1 1 1 1 3 2 1 1 1 1 1 1 0 
0 1 1 2 1 1 1 2 2 1 1 1 1 1 0 
0 3 1 1 1 1 2 2 1 1 1 1 2 1 0 
0 1 1 1 1 1 1 1 1 1 1 1 1 1 0 
0 1 1 1 1 1 1 1 1 1 1 1 1 1 0 
0 1 1 2 1 1 1 1 1 1 1 1 1 1 0 
0 1 1 2 1 1 1 1 1 1 1 1 1 1 0 
0 1 1 1 1 1 2 1 3 1 1 4 1 1 0 
0 0 0 0 0 0 0 0 0 0 0 0 0 0 0 

