// Size Mapa, Initial position, dirty probability, random seed, map
20 14 14 0 1
0 0 0 0 0 0 0 0 0 0 0 0 0 0 0 0 0 0 0 0 
0 1 1 1 1 1 1 1 1 0 0 1 1 3 1 2 1 2 2 0 
0 1 0 0 0 0 0 0 1 0 0 3 2 3 1 1 1 1 1 0 
0 1 0 1 1 2 2 0 1 0 0 1 1 2 1 1 1 2 2 0 
0 2 0 1 1 1 1 2 1 0 0 2 1 1 1 1 1 1 1 0 
0 2 0 1 1 1 1 0 1 1 1 1 1 2 1 1 2 1 1 0 
0 1 0 1 1 1 1 0 1 0 0 3 2 1 1 1 1 1 1 0 
0 1 0 1 0 0 0 0 2 0 0 1 2 2 1 1 1 1 1 0 
0 1 2 1 1 1 3 1 1 0 0 2 2 1 1 1 1 2 1 0 
0 0 0 0 0 0 0 1 0 0 0 0 0 0 0 0 0 0 0 0 
0 0 0 0 0 0 0 1 0 0 0 0 0 0 0 0 0 0 0 0 
0 1 1 1 1 1 1 1 2 0 0 1 1 1 1 1 1 1 1 0 
0 1 1 1 1 1 1 1 2 1 1 1 0 0 0 0 1 0 1 0 
0 1 1 1 1 1 1 1 1 0 0 2 0 3 1 1 4 0 1 0 
0 2 2 1 1 1 2 1 1 0 0 1 0 3 1 1 1 0 1 0 
0 1 2 1 1 1 1 1 1 0 0 1 1 1 1 1 2 0 1 0 
0 1 1 1 1 1 1 1 2 0 0 1 0 1 2 1 1 0 1 0 
0 1 1 1 1 1 1 1 2 0 0 1 0 0 0 0 0 0 1 0 
0 2 1 1 1 1 1 2 1 0 0 1 1 1 1 1 1 1 1 0 
0 0 0 0 0 0 0 0 0 0 0 0 0 0 0 0 0 0 0 0 
