// Size Mapa, Initial position, dirty probability, random seed, map
10 4 4 0 1
0 0 0 0 0 0 0 0 0 0 
0 1 1 1 1 1 1 1 1 0 
0 1 0 0 0 0 0 0 1 0 
0 1 0 1 1 2 2 0 1 0 
0 2 0 1 1 1 1 2 1 0 
0 2 0 1 1 1 1 0 1 0 
0 1 0 1 1 1 1 0 1 0 
0 1 0 1 0 0 0 0 2 0 
0 1 2 1 1 1 3 1 1 0 
0 0 0 0 0 0 0 0 0 0 
