// Initial p0siti0n, dirty pr0bability, rand0m seed, map
10 1 1 1 8
0 0 0 0 0 0 0 0 0 0
0 1 1 1 0 1 1 1 1 0
0 1 0 1 0 0 1 1 1 0
0 3 1 1 0 1 1 0 0 0
0 1 1 1 0 1 1 1 1 0
0 1 0 1 0 3 0 1 1 0
0 1 0 1 1 2 3 1 1 0
0 1 0 0 0 0 0 0 1 0
0 1 1 1 1 3 3 1 1 0
0 0 0 0 0 0 0 0 0 0
