// Size Mapa, Initial position, dirty probability, random seed, map
20 1 1 18 18
0 0 0 0 0 0 0 0 0 0 0 0 0 0 0 0 0 0 0 0 
0 1 1 1 1 1 1 1 1 1 1 1 1 3 1 2 1 2 2 0 
0 1 1 1 1 1 1 1 1 1 1 3 2 3 1 1 1 1 1 0 
0 1 1 1 1 2 2 1 1 1 1 1 1 2 1 1 1 2 2 0 
0 2 1 1 1 1 1 2 1 1 1 2 1 1 1 1 1 1 1 0 
0 2 1 1 1 1 1 1 1 1 1 1 1 2 1 1 2 1 1 0 
0 1 1 1 1 1 1 1 1 1 1 3 2 1 1 1 1 1 1 0 
0 1 1 1 1 1 1 1 2 1 1 1 2 2 1 1 1 1 1 0 
0 1 2 1 1 1 3 1 1 1 1 2 2 1 1 1 1 2 1 0 
0 1 1 1 1 1 1 1 1 1 1 1 1 1 1 1 1 1 1 0 
0 1 1 1 1 1 1 1 1 1 1 1 1 1 1 1 1 1 1 0 
0 1 1 1 1 1 1 1 2 1 1 1 1 1 1 1 1 1 1 0 
0 1 1 1 1 1 1 1 2 1 1 1 1 1 1 1 1 1 1 0 
0 1 1 1 1 1 1 1 1 1 1 2 1 3 1 1 4 1 1 0 
0 2 2 1 1 1 2 1 1 1 1 1 1 3 1 1 1 1 1 0 
0 1 2 1 1 1 1 1 1 1 1 1 1 1 1 1 2 1 1 0 
0 1 1 1 1 1 1 1 2 1 1 1 1 1 2 1 1 1 1 0 
0 1 1 1 1 1 1 1 2 1 1 1 1 1 1 1 1 1 1 0 
0 2 1 1 1 1 1 2 1 1 1 1 1 1 1 1 1 1 1 0 
0 0 0 0 0 0 0 0 0 0 0 0 0 0 0 0 0 0 0 0 
