// Size Mapa, Initial position y orientation jug1, position y orientation jug2, map
10 1 1 2 8 8 0 
0 0 0 0 0 0 0 0 0 0 
0 1 1 1 1 1 1 1 1 0 
0 1 1 1 1 1 1 1 1 0 
0 1 1 1 1 2 2 1 1 0 
0 2 1 1 1 1 1 2 1 0 
0 2 1 1 2 1 1 1 1 0 
0 1 1 1 1 1 1 1 1 0 
0 1 1 1 1 1 1 1 2 0 
0 1 2 1 1 1 2 1 1 0 
0 0 0 0 0 0 0 0 0 0 
